1111111111111111111111111
1C00111111110000000000001
100010000010000C111111C01
1000100000100001000000001
1000000000111101000111001
1111011111100001000100001
1000010000100001000100001
1000010000100001000100001
1000010000111001000100001
100001000P000001000100001
1000010111111101111100001
100000000000000000000C001
1111110111111111001111101
1C00010000000010010000001
1111011000111001001111101
1000011000100001001000001
1000011111100111001000001
1000000000100000X01000001
1111000000111111111000001
100000000C000000000000001
1000111111111111111100001
1000100000000000000100001
1000111001111111000100001
1C000100100000100000000E1
1111111111111111111111111