1111111111111111111111111111111111
100000000000000X000000000000011C11
10000CCC00000P00111110000001111001
10000CCC00000100111110000001111011
10000CCC00001100111110000001111C11
1000000000000000111110000001111011
1000000001111000000011110111110001
1000011100001111011110000000000001
100000000000000000100001111000E001
1111111111111111111111111111111111    
